level 0
1111111111
1111111111
1111111111

level 1
2222222222
1111111111
1111111111

level 2
2121212121
1212121212
4400000044